# # # # # # # # # # # # # # #
. . . . . . . . # . # . . . #
# . # . # # # # # . # # # . #
# . # . # . . . # . # . # . #
# . # # # # # . # . # . # . #
# . # . # . . . . . # . . . #
# . # . # # # . # . # # # . #
# . . . # . . . # . # . # . #
# . # # # # # # # . # . # . #
# . . . # . # . . . # . . . #
# . # # # . # # # . # # # . #
# . . . . . # . # . . . . . #
# . # . # # # . # # # . # . #
# . # . . . . . . . . . # . .
# # # # # # # # # # # # # # #
